        #######x########        
        #..............#        
        #..............#        
        #..............#        
        #.......e......#        
        #..............#        
        #..............#        
        #..............#        
        #..............#        
        #..............#        
        #..............#        
        #..............#        
        #..............#        
        #..............#        
        #......@.......#        
        #..............#        
        #..............#        
        #..............#        
        #..............#        
        #..............#        
        #..............#        
        #..............#        
        #..............#        
        #..............#        
        #..............#        
        #..............#        
        #..............#        
        #..............#        
        #..............#        
        #..............#        
        #..............#        
        ########x#######        